NO textures/north.xpm
SO textures/barrel.xpm
WE textures/west.xpm
EA textures/pillar.xpm

F 194,178,128
C 245,248,230

        111111111111        11111111111111
       1100000000011        110000000000011
      11000000000011        1100000000000011
     110001111110011        1111111110000011
    1100011   110011                11000011
   1100011    110011               111000011
  110C011     110011             1110000111
 1100011      110011           1110000111
 1100011      110011         1110000111
 1100011111111110011111    1110000111
 11000000000000000000011111110000111
 110000N000000000C00000000000000011
 1100000000000000000001111111000011111111111
 1111111111111110011111     1100000000000011
              110011        1100000000000011
              111111        1111111111111111
