11111111111
1CCCCCCCCC1
1CCCCCCCCC1
1CCCCCCCCC1
1   111   1
1   111   1
1   111   1
1    C    1
1   CNC   1
1    C    1
11111D11111
1         1
1CCCCCCCCC1
1CCCCCCCCC1
1   111   1
1   111   1
1   111   1
1CCCCCCCCC1
1CCCCCCCCC1
1CCCCCCCCC1
11111111111

