NO1 <path>
SO1 <path>
WE1 <path>
EA1 <path>

NO2 <path>
SO2 <path>
WE2 <path>
EA2 <path>

NO3 <path>
SO3 <path>
WE3 <path>
EA3 <path>

DC <path> (door when it is closed)
DO <path> (texture that will replace a wall next to a door to indicate an open door)

F 255,255,255
C 123,123,123

        3333333333333333333333333
        1000000000110000000000C01
        10110C0001110000000000001
        100100000000000C000000001
111111111011000001110000000000C01
100000000011000001110222222222222
1111D222211111011100000010001
11110222211111011101010010001
110000001101010111000C0010001
10000000000000001100000010001
10000000000000001101010010001
11000003330101011111011110N0111
11110111 1110101 101111010001
11111111 1111111 111111111111
