111111111
1       111111111111111111111
1                           1
1  E 11111111 1 1 1 1 1 1 1 1
1                           1
1       111111111111111111111
1       1
1       1
1       1
1 1 1 1 1
111111111
