11111111111
1         1
1         1
1         1
1   111   1
1   111   1
1   111   1
1         1
1    N    1
1         1
11111D11111
1         1
1         1
1         1
1   111   1
1   111   1
1   111   1
1         1
1         1
1         1
11111111111

