111111
1    1
1    1
1  E 1
1    1
1    1
111111
